##########
#..#.....#
#..#...#.#
#.....##.#
#......#.#
#.##.....#
#..#..##.#
#..#...#.#
#......#.#
##########
