####################
#...#..............#
#...#.....##...#...#
#......#.......#...#
#......##..##..#...#
#..##......#.......#
#...#......#.......#
#...#..........#...#
####################
